############
#   #     .#
# $ #$#    #
#         $#
###    $   #
#     ######
#  @  ...###
############
;level5