###########
#         #
# $       #
###   #.  #
# $$  #.  #
#@   ##.  #
###########
;level4