########
#  .# .#
# $   @#
# $$## #
#     .#
########
;level2