###############
#   #   #     #
#####$  #     #
#             #
# #$#$## ######
#   # ## ##   #
# $           #
# $#$## #@#...#
#  #    ###...#
###############
;level6