##############
#            #
# ######*### #
# # $ $ $  # #
# # . . ..$# #
# $  ####  # #
# # .#  $.$# #
# #$.#$ #* # #
# # .   #.$# #
# # #####  . #
# #$.. . . # #
# #  $@$ $ # #
# ###*###### #
#            #
##############
;level7