########
# $.# .#
#     @#
# $$#$ #
#    ..#
########
;level3