########
#. #   #
#  $   #
#   # ##
## # $.#
#   $  #
#  .# @#
########
;level1